###############
#            \#
# ########### #
# #         # #
# ########### #
# .           #
###############
