#######
#     #
#.#=#.#
#   \ #
#######
