#######
#     #
#.#\#.#
#    =#
#######
