###############
#            \#
# ########### #
# #         # #
# ########### #
#.            #
###############
