###############
#  .          #
# ########### #
# #         # #
# ########### #
#           .\#
###############
