###################
#= .o..   \.... ..#
# ### ###.### ### #
#.### ###=### ###.#
#o###.###=###o### #
#... %    o .=    #
###################
