#####################
#= .o..   ....%= ..=#
# ##### #####=#####.#
# ##### #####.##### #
# #####.#####.#####o#
# #####.#####.#####.#
# ##### ##### ##### #
#  .   o   ....\... #
#####################
