##################
# ...   ..o.. .\.#
# ####o#### ####.#
# ####%#### ####o#
#.#### #### ####=#
#.####.####=#### #
#...= =     .    #
##################
