###############
# ...   .=... #
#.###.### ### #
#.### ### ###.#
#o###o###o### #
#= .=.%= ..\. #
###############
