###########################
# o...=   .... ..  .  .  .#
#.##### #####.#####.#####.#
# ##### ##### ##### ##### #
# #####.##### ##### #####=#
#=##### ##### ##### ##### #
#.#####.#####.#####.#####o#
#... .oo...   .= ..%     \#
###########################
