#######################
# \... =o o .... ..  .#
# #### ####.#### #### #
#.####.#### ####%####.#
#.####.#### #### #### #
# #### #### ####.#### #
#    o =....=o...= ...#
#######################
