###############
# ...   .... =#
#.###.#=### # #
#.#  .# # #.#.#
# #.###.#.# # #
# # #  .  #   #
# #.#####o###.#
#o#.....# #.#.#
#.#####\###.# #
# # . ..#   # #
# # #####.###.#
#.#..  .# #. =#
#.#####.#.### #
#.  #.#.  #...#
# # #.#####.#=#
#.#    .  # #.#
# #######.#.#.#
#o  . .  .o  .#
###############

