#####################
#..............o....#
#.##.##.##.##.##.## #
#.##.##.##.##.##.##.#
#. o................#
#.##\##.##.## ##.##.#
#.##.##.##.## ##.##.#
#........ .... .....#
#.##.##.##.## ##.##.#
#.##.##.##.##.##.##.#
# . .......=... ....#
# ##.##.##.##.##.##.#
#.##.##.##.##.##.## #
#..... .............#
#.##.##.## ##.##.##.#
#.##.##.##.##.##.##.#
#.. ...... .........#
#.##.## ##.##.##.##.#
#=##.##.##.##.##.##.#
# .... .  ....... ..#
#####################
