##############################
#.............o........... ..#
#.##.##.##.##.##.## ##o##.##.#
#.##.##.##.##.##.##.##.##.##.#
#....... ....o.. .......... .#
#.##.##.## ##=##.##.##.##.##.#
#.##.##.##.## ##.##.##.##.##.#
#.... . .......... .... .....#
#.##.##.##.##.##.##.## ##.##.#
#.##.##.## ##.##.##.##.##.##.#
#.......... ............ ....#
#.##.## ##.##.##.##.##.##.##.#
#.##.##.##.## ##.##.##.##.##.#
#..... .... .  ....... ....  #
#.##.##.##.## ##.##.##.##.##.#
#=##.##.##.## ##.##.##.##.##.#
#........ ..........  ... ...#
#.##.##.##.## ##.##=##.##.##.#
#.## ##.##.##.##.##=##.##.##.#
#.... ...........%... .......#
#.##.##.##.##.##.##.##.##.##.#
#.## ##.## ##.##.##.##.##.## #
#.................. \... . . #
#.## ##.##.##.##.##.##.##.##.#
#.##.##.##.## ##.##.##.##.##.#
#............. . ....o.......#
#.## ##.##=##.##.##.##.##.##.#
#.##.##.##.##.##.##.##.##.##.#
#............ ....... . .....#
##############################
