#####################
# ...   o. .. .o.  .#
# #### ####.#### ####
# #### ####.#### ####
# ####.####.#### ####
# #### #### #### ####
#        .=......   #
#.####.#### #### ####
# ####.#### ####.####
# #### #### #### ####
#=#### ####o####o####
#  .. ..   =    .. .#
# #### #### ####.####
# #### ####.####.####
#%####.####=#### ####
# #### ####.#### ####
#    .   . .    . . #
# ####.#### #### ####
#\####=####.#### ####
# #### #### ####.####
#####################
