#####################
#..............o....#
#.##.##.##.##.##.## #
#.##.##.##.##.##.##.#
#. o................#
#.##\##.##.## ##.##.#
#.##.##.##=##.## ##.#
#......... .... ....#
#.##.##.##.##.## ##.#
#.##.##.##.##.##.##.#
#=. . .....o..... ..#
#.##.## ##.##.##.##.#
#.##=##.##.##=##.##.#
#... ..... .%.......#
#.##.##.##.##.##.##.#
#.## ##.##.##.##.##.#
#....... ...... ....#
#.##.##.##.##.##.##.#
#o## ##=##.##.##.##.#
#...... .... .  ....#
#####################
