###############
# ...   . .o. #
#=##.##.## ## #
#.## ## ##.## #
#  \.  =..    #
# ## ## ## ## #
# ## ## ## ##.#
#...... o o ..#
# ## ## ##.## #
#.## ## ## ## #
#%   .. ..    #
# ## ## ##.##.#
# ##.## ## ## #
#o. == .=..   #
###############
