###############
#..........o..#
#=####o####=###
#.####.####.###
#=####.####=###
#.####.####.###
#..... .......#
#.#### ####.###
#.####.####.###
#.####.####.###
#.####.####.###
#.........\ o.#
#.####%####=###
#o####.####.###
###############
