#####################
#.......o......o....#
#.####.####.####.####
#.####.####.#### ####
#.####.####.####.####
#.####.####.####.####
# ........=.........#
#.####.#### ####.####
#.####.####.####.####
#.#### ####.####.####
#=####.####o####o####
#....... ..=.. .....#
#.####.####.####.####
# ####.####.####.####
#%####.####=####.####
#.####.####.####.####
# . .......... .... #
#.####.####.####.####
#\####=####.####.####
#.####.####.####.####
#####################
