#####################
# ...   . .. ..o  . #
# ##.## ## ## ##.## #
# ##.##.## ## ## ## #
#  o       .......  #
# ##\##.##.## ## ## #
#.## ##.##=## ## ## #
#    .. ..       .. #
#.## ## ## ##.## ## #
#.##.##.## ## ## ##.#
#=     .   o. .    .#
# ##.## ## ##.## ## #
#.##=## ## ##=## ## #
#. .    .  .% .  .  #
#.## ## ##.## ## ##.#
# ## ## ## ## ##.##.#
#  ... .  .. ..     #
#.##.## ## ## ## ## #
#o## ##=##.## ## ## #
#..  ..    .     . .#
#####################
