###################################
# ...   . .. .. o =.  .   .  .o.  #
# ## ## ## ## ## ## ## ## ## ## ###
#.##.##.##.##.##.##.## ## ## ##.###
#.   . .       .. ..       .. .   #
#.##o## ## ##.##.##.## ## ## ##.###
# ## ## ## ## ##.## ## ## ##.## ###
#.    . .  .  .    . .    .  . .  #
#.## ## ##.## ## ##.## ## ##.## ###
# ## ##\## ## ##.##.## ## ##.##.###
#. .  .. ..     .=.      .   ..  .#
#.## ## ## ## ##.## ## ## ## ## ###
#.## ##.## ##.## ## ##.## ## ## ###
#    ..    .   . ..  .. .      . .#
# ## ##.## ## ##.## ## ## ##.##.###
#.## ## ## ## ##.## ## ## ## ## ###
#. .  ... .  . .   . ..o  .   ..  #
# ## ## ##.##.## ## ## ## ## ##.###
#.##.## ## ## ## ##.## ## ## ## ###
# .      . .  .    ...   .     . .#
# ##.##.## ## ## ## ## ## ## ##.###
# ##.## ## ## ## ## ##=## ##.## ###
#        ..       ..     .   ..   #
# ## ## ##.##.##.##.## ## ##.## ###
# ##.## ## ##.## ##.## ## ##.## ###
#.  ..                ..    ....  #
#.##.## ## ##.## ## ## ##.## ## ###
# ## ## ## ## ##.## ## ## ## ## ###
#   .. .   . .% .  . . . .     ...#
# ## ## ## ## ## ## ## ##.##.##.###
#.## ## ##.## ## ##.## ## ##.## ###
# ..     . == .   .         .     #
# ## ##.## ## ## ## ## ##.## ## ###
#.## ##.## ## ## ##.## ##.##.## ###
###################################
