###############
#..........o..#
#=##.##.##.##.#
#.##.##.##.##.#
#..\. .=......#
#.## ##.##.##.#
#.##.##.##.##.#
#.......o.o...#
# ##.##.##.##.#
#.##.## ##.##.#
#%........ ...#
#.## ##.##.##.#
#.##.##.##.##.#
#o. ==..=.....#
###############
