##############################
# ...   . .. .o.  .  .   .  .#
#.## ## ## ## ## ## ##o## ## #
# ## ## ## ## ##.##.##.##.##.#
#..   ..   . o.       .. ..  #
# ## ## ## ##=## ##.##.## ##.#
# ## ## ##.## ## ##.##.##.## #
#  .     .   . .    . .  .  .#
# ## ## ## ##.## ##.## ## ## #
# ##.## ## ##.## ##.## ## ##.#
#  .  .  .     ..  ... .  .. #
#.##.## ## ## ## ## ##.##.## #
# ## ## ## ## ##.## ## ## ##.#
#.  ..    .     . . .  .     #
# ## ##.##.## ## ## ## ##.## #
#=## ## ##.## ##.##.## ## ##.#
#. .      . .  .  .   ...    #
#.## ## ## ## ## ##=##.## ##.#
# ## ##.##.##.## ##=##.## ## #
#. .   . ..  .   %..     ..  #
# ## ## ##.##.##.## ## ## ## #
#.## ## ## ## ## ##.## ## ## #
#   . .  .    ...   \.     . #
#.## ##.##.## ## ## ## ## ## #
# ##.## ##.## ## ## ## ## ## #
#.         ..       .o.     .#
# ## ## ##=##.##.## ## ## ## #
# ## ##.##.##.##.## ## ##.## #
# .  . .  . .  ..            #
##############################
