##############################
# ...   . .. .o.  .  .   .o  #
#.####.#### #### #### #### ###
# #### #### #### #### #### ###
# #### #### ####.####.####.###
#.####.####.####.#### #### ###
# .. o  . .       .. ..      #
# ####.####.#### ####.#### ###
# ####\#### ####.####=#### ###
# ####.####.####.#### #### ###
# ####.#### #### #### #### ###
# .   .% .    . .  .  .    . #
#.#### #### #### #### ####.###
# #### ####.#### ####.#### ###
# ####.#### #### ####.#### ###
#=#### ####.####=#### #### ###
#.     .. = ... .  .. ..     #
#.####.#### #### #### #### ###
# #### ####.#### #### #### ###
#.####.#### #### ####.####.###
# #### #### #### ####.#### ###
#    . . .  .       ..    .  #
# ####.#### ####.####.#### ###
# ####.####.#### ####.#### ###
# #### #### #### #### ####.###
# ####.#### #### ####.#### ###
# o.   ...=    .     . .  ...#
# ####.#### #### ####.#### ###
#.#### #### #### ####.#### ###
##############################
