###################################
#...............o......%... ..o...#
#.####.####.#### ####.####o####.###
#.####.####.####.####.####.####.###
#.####.####.####.####.####.####.###
#.####.####.#### ####.####.####.###
#..=. .......... .... ......... ..#
#.####.####.####.####.####.####.###
# ####o####.#### ####.####.####.###
#.####.####.####.####.####.####.###
# ####.####.####.####.#### ####.###
#........... ..... ...............#
#.#### ####.####.####.####.####.###
#.####.####.####.####.####.####.###
# ####.####.####.####.####.####.###
# ####.####.####.####.####.####.###
#..... .......... .... .  ....... #
#.####.####.####.#### #### ####.###
#.####.####.#### ####.####.####.###
#.####.####=####.####.####.#### ###
#.####=####.####.####.####.####.###
#....... ..........  ... ....... .#
#.####.####.####.#### ####.####.###
#.####.####.####.####.####.####.###
#.####.#### ####.####.####.####.###
#.####.####.####.####.####.####.###
#... .................. . ..... ..#
#.####.####.####.####.####.####.###
#.####.####.####.####.####.####.###
#.####.#### ####.####.####.#### ###
#.#### ####.#### ####.#### ####.###
#..\.......==.. ..................#
# ####.#### ####.####.####.####.###
#.####.####.####.####.####.####.###
###################################
