##############################
#.............o...........o .#
#.####.####.####.####.####.###
#.#### ####.####.####.####.###
#.####.####.####.####.####.###
#.####.####.####.####.####.###
#... o...... .......... .... #
#.####.####.####.####.####.###
#.####\####.####.####=#### ###
#.####.####.####.####.####.###
#.####.####.#### ####.#### ###
#......%.... .... ...........#
#.#### ####.####.####.####.###
#.#### ####.####.####.####.###
#.####.####.####.####.####.###
#=####.####.####=####.####.###
#.. ......=...... ...... ....#
#.####.####.####.####.####.###
#.#### ####.####.####.####.###
#.####.####.####.####.####.###
# ####.####.####.####.#### ###
#.  ....... ....  .... ......#
#.####.#### ####.####.####.###
#.####.####.####.####.####.###
#.####.####.####.#### ####.###
#.####.####.####.####.####.###
#.o..  ...= ....... ..... ...#
#.####.####.####.####.####.###
#.####.#### ####.####.####.###
##############################
