###############
# ...   . .o. #
#=####o####=###
#.####.#### ###
#=#### ####=###
#.#### #### ###
#.   .  ..    #
# #### #### ###
# #### #### ###
# #### #### ###
#.####.####.###
#....   ..\ o #
# ####%####=###
#o####.#### ###
###############
