###################################
#...............o.=........ ..o...#
#.##.##.## ##.##.##.##.##.##.##.###
#.##.##.##.##.##.##.##.##.##.##.###
#. ...... .......... .... ........#
#.##o## ##.##.##.##.##.##.##.##.###
#.## ##.## ##.##.##.##.##.##.##.###
#... .... ............ ..... .....#
#.##.##.##.##.##.##.##.##.##.##.###
# ##.##\##.##.##.##.##.##.##.##.###
#... ...... .....=...... .........#
#.## ##.##.##.##.## ##.## ## ##.###
#.##.##.##.##.##.## ##.##.##.##.###
#  .... ........ ............. ...#
#.##.##.##.##.##.##.## ## ##.##.###
#.## ##.##.##.##.##.##.##.## ##.###
#.... ........... .....o......... #
#.##.##.##.##.##.##.##.##.##.##.###
#.##.##.##.##.##.##.## ##.## ##.###
#.... .................. ... . . .#
# ##.##.##.##.##.##.##.##.##.##.###
#.##.## ##.##.##.##.##=##.##.##.###
#........... . ............ ......#
#.##.##.##.##.##.##.##.##.##.##.###
#.##.##.##.##.##.##.##.##.##.##.###
#. ....... . .....................#
#.##.##.##.##.##.##.##.##.##.## ###
#.##.##.##.##.##.##.##.##.## ##.###
#.............%...................#
#.## ##.##.##.##.##.## ##.##.##.###
#.##.##.##.##.##.##.##.##.##.##.###
# .... ....==...... ......... ....#
#.## ##.##.##.##.##.##.##.##.##.###
#.##.##.##.##.##.##.##.##.##.##.###
###################################
