###################################
# ...   . .. .. o .  . %  .  .o.  #
# #### #### #### #### ####o#### ###
# #### #### #### #### ####.####.###
#.####.####.####.####.#### #### ###
# ####.####.#### #### #### ####.###
# .=       .. ..       .. .   .  .#
#.####.#### #### #### ####.#### ###
# ####o#### #### #### ####.#### ###
# #### ####.#### ####.#### #### ###
# #### ####.#### ####.#### #### ###
#.  .    . .    .  . .  .  .  .  .#
# #### #### #### #### ####.####.###
# #### ####.####.####.#### ####.###
# #### ####.####.#### ####.####.###
# #### #### #### #### ####.####.###
#      .   ..  ..    .     . . .  #
#.#### #### #### #### #### #### ###
# ####.####.#### #### #### #### ###
#.#### ####=#### #### ####.#### ###
#.####=####.#### #### ####.####.###
# .      . .  .  .   ...    .     #
#.#### ####.#### #### ####.####.###
#.#### ####.#### #### ####.#### ###
#.#### #### #### ####.#### ####.###
#.#### #### ####.#### #### #### ###
#..     ..     ...    .     .     #
# ####.#### ####.#### #### ####.###
# #### #### #### ####.####.####.###
# #### #### ####.#### #### #### ###
# #### ####.#### ####.#### ####.###
#. \      .== .      .         .. #
# #### #### #### #### #### ####.###
#.#### #### #### #### #### ####.###
###################################
