#######################
#.....#....#....#     #
#.###=####.#.####.###.#
#ooo#o%....\......#..o#
#.####=################
#..........#..........#
#      #              #
#######################
