#####################
# ... # . .. ..o  . #
# ##.## ## ## ##.## #
# ##.##.## ## ## ## #
#          ....#..  #
# ## ##.##.## ## ## #
#.## ##.##=## ##### #
#    ..#..       .. #
#.## ## o# ##.## ## #
#.##.##.## ##### ##.#
#=   % .   o. .    .#
# ##.## ## ##.## ## #
#\##=#   # ##=## ## #
#. .   #.  .  .  .  #
#.## #   #.## ## ##.#
# ## ## ## #####.##.#
#  ... . #.. ..     #
#.##.## ## ## ## ## #
#o## ##=##.## ## ## #
#..  .. #  .     . .#
#####################
