#####################################
#                                   #
#     #######################       #
#     #.....................#       #
#     #.....................#       #
#     #..........o..........#       #
#     #.....................#       #
#     #.....................#       #
#     #..........%..........#       #
#     #.....................#       #
#############   ===   ###############
#   #       #    \    #     #       #
#    #      #         #      #      #
#    ##     #         #      ##     #
#   #  #    #         #     #  #    #
#  #    #   #         #    #    #   #
#############    o    ###############
#          =###########=            #
#               ===                 #
#                                   #
#                                   #
#                                   #
#                                   #
#                                   #
#                                   #
#                                   #
#          ##         ##            #
#            #########              #
#                                   #
#                                   #
#####################################
