#####
#\  #
#=# #
#.# #
# #.#
#####
