#####
#\  #
# #.#
#  %#
#####
