#####
#\  #
# #.#
# o%#
#####
