##########################################
#=\..  ..  ..   ........o . . . . . . . %#
## ############ ##########################
#                                        #
############### ##########################
###########         ######### ############
###########         ########## ###########
###########         ######### # ##########
###########         ######## ### #########
##########################################
