#####################################
#                                   #
#                                   #
#                                   #
#            ====\               o.%#
#                                   #
#                                   #
#                                   #
#####################################
