##############
#o....%......#
#.#.######.#.#
#.#...##...#.#
#.#.#====#.#.#
#...######...#
###.#..\.#.###
#...#.##.#...#
#.#...##...#.#
#.###.##.###.#
#.....##....o#
##############
