###############
# ...   .... =#
#.#.# ### ###.#
# # #.  #.. #.#
#.#.####### # #
# #   #.    # #
# ###.#.#####.#
#...#o. #...o.#
# # # #######.#
# #.#.#=      #
#.#.#.#.#####.#
# # #.# #. .#=#
#.#.# #.# #\# #
#.. # #.#.#.  #
#.###.#.# ###=#
# #  .# #  . .#
#.#####.##### #
#o . .  . o . #
###############

