###############
# ...   .... =#
#.#######.### #
# #.  .  .. ..#
#.########### #
#     .      .#
#.###########.#
#.#... ...#.# #
# #####o# #.# #
#.=.   =#   #.#
#.###.#######.#
#.  #.# o.# .=#
#.###.# #.#\# #
# ..  #.#.. # #
#.#####.#####.#
#    .  # . ..#
#.########### #
#o . .  . o . #
###############

